0000000000000000000000000000000000
0000000000000000000000000000000000
0000000000000000000000000000000000
0000000000000000000000000000000000
0000000000000000000000000000000000
0000000000000000000000000000000000
0000000080000000000000000000000000
0000008880000000000000000000000000
0000088000000008000000000000000000
0000880000000088000000000000000000
0p08880000000888000000000008000000
8888880000888888888800880088888888
ssssssssssssssssssssssssssssssssss
